NO ./pics/wall_n.xpm
SO ./pics/wall_s.xpm
WE ./pics/wall_w.xpm
EA ./pics/wall_e.xpm

F 159,201,60
C 225,30,0

        1111111111111111111111111
        1W00000000110000000000001
        1011000001110000000000001
        1001000000000000000000001
111111111011000001110000000000001
100000000011000001110111111111111
11110111111111011100000010001
11110111111111011101010000001
11000000110101011100000010001
10000000000000000000000010001
10000000000000001101010010001
1100000111010101111101111000111
11110111 1110101 101111010001
11111111 1111111 11111111111111111111111
